COOL

030030030001001001001001001027001023023023023023023023023023023023023023023023023023
031001001007001023023023027023023023023023023023023023023023023023023023023023023023
001009007009007007023023023023023023023023023023023023023023023023023023023023023023
009009009009007007007007023023023023023023023023023023023023023023023023023023023023
009009009027009027007023023023023023023023023023023023023023023023023023023023023023
023023023023023023023023023023023023023023023023023023023023023023023023023023023023
023023023023023023023023023023023023023023023023023023023023023023023023023023023023
023023023023023023023023023023014014014014023023023023023023023023023023023023023023
023023023023023023023023023023016032016016016016023023023023023023023023023023023023
023023023023023023023023023023023023032032032034023023023023023023023023023023023023
023023023023023023023023023023023023023023023023023023023023023023023023023023023023
001001001023023023023020023035023035023023023023023023023023023023023023023023023023
001020023020020020020020035022035035035023023023023023023023023023023023023023023023
020023020023020023020023022023023023023023023023023023023023023023023023023023023023
